<map>
    name:castleEntrance

    <mapCharacter>
        // stone floor
        character:.
        displayCharacter:'.'
        material:stone
    </mapCharacter>

    <mapCharacter>
        // stone wall
        character:#
        displayCharacter:'#'
        material:stone
        <solid>
        <opaque>
    </mapCharacter>

    <mapCharacter>
        // wooden door
        character:+
        displayCharacter:'+'
        material:wood
        <solid>
        <opaque>
    </mapCharacter>

    <mapCharacter>
        // wooden torch
        character:*
        displayCharacter:'*'
        material:wood
        light:torch
        <solid>
    </mapCharacter>

    <mapCharacter>
        // red stained glass
        character::
        displayCharacter:' '
        material:glass
        light:stainedGlassRed
        <solid>
    </mapCharacter>

    <mapCharacter>
        // green stained glass
        character:'
        displayCharacter:' '
        material:glass
        light:stainedGlassGreen
        <solid>
    </mapCharacter>

    <mapCharacter>
        // blue stained glass
        character:;
        displayCharacter:' '
        material:glass
        light:stainedGlassBlue
        <solid>
    </mapCharacter>

    <mapCharacter>
        // player spawn
        character:@
        displayCharacter:'.'
        material:stone
        <playerSpawn>
    </mapCharacter>

    <tiles>
###################+###################
#..........*...............*..........#
#.....................................#
#.....................................#
#.....................................#
#.....................................#
#.....................................#
#.....................................#
#.....................................#
#.....................................#
#.....................................#
#.....................................#
#.....................................#
#.....................................#
#.....................................#
#.....................................#
#.....................................#
#.....................................#
#.....................................#
#.....................................#
#.....................................#
#.....................................#
#.....................................#
'.....................................'
#.....................................#
#.....................................#
#.....................................#
#.....................................#
#.....................................#
#.....................................#
:.....................................:
#.....................................#
#.....................................#
#.....................................#
#.....................................#
#.....................................#
#.....................................#
;.....................................;
#.....................................#
#.....................................#
#.....................................#
#.....................................#
#.....................................#
#.....................................#
#.....................................#
#.....................................#
#.....................................#
#.....................................#
#.....................................#
#.....................................#
#.....................................#
#.....................................#
#.....................................#
#.....................................#
#.....................................#
#.....................................#
#.....................................#
#.....................................#
#.....................................#
#.....................................#
#.....................................#
#.....................................#
#.....................................#
#.....................................#
#.....................................#
#.....................................#
#.....................................#
#.....................................#
#.....................................#
#.....................................#
#.....................................#
'.....................................'
#.....................................#
#.....................................#
#.....................................#
#.....................................#
#.....................................#
#.....................................#
:.....................................:
#.....................................#
#.....................................#
#.....................................#
#.....................................#
#.....................................#
#.....................................#
;.....................................;
#.....................................#
#.....................................#
#.....................................#
#.....................................#
#.....................................#
#.....................................#
#.....................................#
#.....................................#
#.....................................#
#.....................................#
#.....................................#
#.....................................#
#.....................................#
#.....................................#
#.....................................#
#.....................................#
#.....................................#
#.....................................#
#.....................................#
#.....................................#
#.....................................#
#.....................................#
#.....................................#
#.....................................#
#.....................................#
#.....................................#
#.....................................#
#.....................................#
#.....................................#
#.....................................#
#.....................................#
#.....................................#
#.....................................#
#.....................................#
#.....................................#
#.....................................#
#.....................................#
#.....................................#
#.....................................#
#.....................................#
#.....................................#
'.....................................'
#.....................................#
#.....................................#
#.....................................#
#.....................................#
#.....................................#
#.....................................#
:.....................................:
#.....................................#
#.....................................#
#.....................................#
#.....................................#
#.....................................#
#.....................................#
;.....................................;
#.....................................#
#.....................................#
#.....................................#
#.....................................#
#.....................................#
#.....................................#
#.....................................#
#.....................................#
#.....................................#
#.....................................#
#.....................................#
#.....................................#
#.....................................#
#.....................................#
#.....................................#
#.....................................#
#.....................................#
#.....................................#
#.....................................#
#.....................................#
#.....................................#
#.....................................#
#.....................................#
#.....................................#
#.....................................#
#.....................................#
#.....................................#
#.....................................#
#.....................................#
#.....................................#
#.....................................#
#.....................................#
#.....................................#
#.....................................#
#.....................................#
#.....................................#
#.....................................#
#.....................................#
#.....................................#
#.....................................#
#.....................................#
#.....................................#
#.....................................#
#.....................................#
#.....................................#
#.....................................#
#..................@..................#
###################+###################
    </tiles>
</map>
