<map>
    name:castleEntrance

    <mapCharacter>
        // stone floor
        character:.
        displayCharacter:'.'
        characterColor:stone
    </mapCharacter>

    <mapCharacter>
        // stone wall
        character:#
        displayCharacter:'#'
        characterColor:stone
        <solid>
        <opaque>
    </mapCharacter>

    <mapCharacter>
        // torch
        character:*
        displayCharacter:'*'
        characterColor:wood
        light:torch
    </mapCharacter>

    <mapCharacter>
        // player spawn
        character:@
        displayCharacter:'+'
        characterColor:wood
        <playerSpawn>
    </mapCharacter>

    <tiles>
#########################################
#.......................................#
#.......................................#
#.......................................#
#.......................................#
#.......................................#
#.......................................#
#.......................................#
#.......................................#
#.......................................#
#.......................................#
#.......................................#
#.......................................#
#.......................................#
#.......................................#
#.......................................#
#.......................................#
#.......................................#
#.......................................#
#.......................................#
#.......................................#
#.......................................#
#.......................................#
#.......................................#
#.......................................#
#.......................................#
#.......................................#
#.......................................#
#.......................................#
#.......................................#
#.......................................#
#.......................................#
#.......................................#
#.......................................#
#.......................................#
#....*.............................*....#
#.......................................#
#.......................................#
#.......................................#
#.......................................#
####################@####################
    </tiles>
</map>
