<map>
    name:castleEntrance

    <mapCharacter>
        character:.
        displayCharacter:.
        characterColor:stone
    </mapCharacter>

    <mapCharacter>
        character:#
        displayCharacter:#
        characterColor:stone
        <solid>
        <opaque>
    </mapCharacter>

    <mapCharacter>
        character:*
        displayCharacter:*
        characterColor:wood
        light:torch
    </mapCharacter>

    <mapCharacter>
        character:@
        displayCharacter:+
        characterColor:wood
        <playerSpawn>
    </mapCharacter>

    <tiles>
#########################
#.......................#
#.......................#
#.......................#
#.......................#
#.......................#
#.......................#
#.......................#
#.......................#
#.......................#
#.......................#
#.......................#
#.......................#
#.......................#
#.......................#
#.......................#
#.......................#
#.......................#
#.......................#
#.......................#
#.......................#
#.......................#
#.......................#
#.......................#
#.......................#
#...........*...........#
#.......................#
#.......................#
#.......................#
#.......................#
#.......................#
#.......................#
#.......................#
#.......................#
#.......................#
#.......................#
#.......................#
#.......................#
#.......................#
#.......................#
############@############
    </tiles>
</map>
