<map>
    name:castleEntrance

    <mapCharacter>
        character:.
        displayCharacter:.
        characterColor:stone
        characterUnseenColor:stone_dark
    </mapCharacter>

    <mapCharacter>
        character:#
        displayCharacter:#
        characterColor:stone
        characterUnseenColor:stone_dark
        <solid>
        <opaque>
    </mapCharacter>

    <mapCharacter>
        character:*
        displayCharacter:*
        characterColor:wood
        characterUnseenColor:wood_dark
        <lightSource>
    </mapCharacter>

    <mapCharacter>
        character:@
        displayCharacter:+
        characterColor:wood
        characterUnseenColor:wood_dark
        <playerSpawn>
    </mapCharacter>

    <tiles>
#########################
#.......................#
#.......................#
#.......................#
#.......................#
#.......................#
#.......................#
#.......................#
#.......................#
#.......................#
#.......................#
#.......................#
#.......................#
#.......................#
#.......................#
#.......................#
#.......................#
#.......................#
#.......................#
#.......................#
#.......................#
#.......................#
#.......................#
#.......................#
#.......................#
#.......................#
#.......................#
#.......................#
#.......................#
#.......................#
#.......................#
#.......................#
#.......................#
#.......................#
#.......................#
#.......................#
#.##.................##.#
#.##*...............*##.#
#.##.................##.#
#.......................#
############@############
    </tiles>
</map>
